*************
*     *     *
***   * * * *
*   * * *   *
* ** **** ***
* *     *   *
* * ***  ** *
* * * *   * *
* * * * * * *
* * * *   * *
* * *   **  *
*     *     *
*************
