*************
*   *   *   *
* *     * * *
* *   *   * *
* *** * *** *
*   * * * * *
* * * * * * *
* * * * * * *
*** * * * * *
*   * * * * *
* **** ** * *
*           *
*************
