*******
*     *
**  * *
*   * *
* **  *
*     *
*******
