*************
*           *
****  * * * *
*     * * * *
* ******* * *
* *       * *
* * ******* *
*     *     *
*** *** * * *
* * *   *   *
* *   ***** *
*     *     *
*************
