*************
*       *   *
*** * * **  *
*     *   * *
* * *** * * *
* *     * * *
* * * *** * *
* * *   * * *
*  ** * * * *
* *     * * *
*   ***** * *
*           *
*************
