*********
*       *
* *** * *
*     * *
*  **** *
*       *
* * *** *
*   *   *
*********
