*************
*   *       *
*** * ** ** *
*   * *     *
* *** *     *
*       * * *
* ***** * * *
*   *     * *
*   ***** * *
*   *       *
***  **  ** *
*       *   *
*************
