***********
*       * *
* * *** * *
* * *     *
*** ***** *
* *     * *
*  **** * *
* *   * * *
* * * * * *
*       * *
***********
