*************
*     *     *
* **  ****  *
*     *   * *
* * * * * * *
* *   *   * *
* * *** **  *
* * *   *   *
* * * *** * *
* *   *   * *
* ********* *
*           *
*************
