***********
*       * *
* *  ** * *
* *   * * *
*   * *   *
* * *     *
* *** *** *
*   *   * *
* * **  * *
*       * *
***********
