***********
*     *   *
* **  * * *
*   *     *
*** * * ***
*   *   * *
* ** ** * *
* *   * * *
* * * *** *
*   *     *
***********
