*********
*   *   *
*** * * *
*     * *
* ***  **
* *   * *
* * **  *
*       *
*********
