*************
*           *
*  ** *  ** *
* *   * *   *
* *   * * * *
*   * * *   *
*** * * * * *
*     * *   *
* ** *   ** *
*   * *     *
*** * * *****
*     *     *
*************
