*************
*     *     *
*  **** * ***
*           *
* ********* *
*     *   * *
* *** * * * *
*     * * * *
* ***** * * *
*     * * * *
***** * * * *
*           *
*************
