*********
*       *
** *  ***
*     * *
*  ** * *
*   * * *
* * **  *
* *     *
*********
