***********
*   *     *
* *   *** *
*       * *
* * ***** *
*   *     *
* * ***   *
* *       *
* *** *** *
*     *   *
***********
