*******
*     *
* * * *
*     *
* * ***
*     *
*******
