*********
* *     *
* *  ** *
*   *   *
* **  * *
*     * *
* ***** *
* *     *
*********
