*************
*           *
* * *** **  *
*         * *
* *** ***** *
* *   *   * *
* * * * * * *
*   * * *   *
* * * * *** *
*   * *   * *
* *** **  * *
*         * *
*************
