*********
*       *
**  * ***
*   * * *
* **  * *
*       *
* ***** *
*       *
*********
