*********
*       *
* *  ** *
* * *   *
* * * ***
* * *   *
* *  ****
* *     *
*********
