*****
*   *
**  *
*   *
*****
