***********
*   *   * *
* * * * * *
*   * *   *
* *** *** *
* *   *   *
*   ***** *
*   *   * *
* **  * * *
*     *   *
***********
