*******
*     *
* * ***
*   * *
* *   *
*     *
*******
