***********
*         *
* * * *** *
* * * *   *
*** * * * *
*   *   * *
*   ****  *
* *     * *
*** ***   *
*     *   *
***********
