*****
* * *
* * *
*   *
*****
