***********
* *   *   *
* * *   * *
*   *   * *
*   ***** *
* *       *
*** ***** *
*   * *   *
* *** * * *
*         *
***********
