*************
*       *   *
* * ***** * *
* *     *   *
*** *** *** *
*       *   *
* ******* * *
*         * *
*  ******** *
*       *   *
****  * * * *
*           *
*************
