*********
* *     *
* * * * *
* * * * *
* * * * *
* * *   *
* *  *  *
*     * *
*********
