*******
*     *
***** *
*     *
* * * *
* *   *
*******
