*********
*   *   *
* *   ***
* *   * *
*  **** *
*   *   *
*** * * *
*     * *
*********
