*********
*       *
* **  * *
*   *   *
*   *** *
*     * *
* *** * *
*       *
*********
