*********
* *   * *
* * *** *
* *     *
* ** ** *
*     * *
* *** * *
*       *
*********
