***********
*     *   *
***** * ***
*     * * *
* ***** * *
*       * *
* **  *** *
*   *     *
*** *** * *
*       * *
***********
