*********
*       *
*** * * *
*       *
* *** ***
*   * * *
*** * * *
*       *
*********
