*************
* *         *
* *   *** * *
* * *   *   *
* * **   ****
* * * *     *
* * * ***** *
*   *     * *
* *** ***** *
* *   *     *
* **  ** ****
*           *
*************
