***********
*       * *
* * *   * *
* * *   * *
* * * * * *
* * *   * *
* * * * * *
* * * *   *
* * *  ****
*   *     *
***********
