*************
*       *   *
* * *** * * *
* * *   * * *
* *   *** * *
* * * *   * *
*** * *  ** *
*   *   *   *
* ******  ***
*     *   * *
***     *** *
*   *       *
*************
