*************
*           *
* *** * *** *
*   * * *   *
*   * * *** *
* *   *     *
* *** * * ***
*     * *   *
*** *** *** *
* * *       *
* * * ***** *
*     *     *
*************
