*******
*     *
* * ***
*     *
****  *
*     *
*******
