*******
*     *
* *****
*   * *
* * * *
* *   *
*******
