*******
*   * *
* * * *
* * * *
* * * *
*     *
*******
