*********
*       *
* *** * *
*     * *
*** *** *
*   *   *
* *   ***
*   *   *
*********
