*****
*   *
*** *
*   *
*****
