*******
* *   *
* * * *
* *   *
* * ***
*     *
*******
