*******
* *   *
* * * *
*   * *
* *** *
* *   *
*******
