*****
*   *
* ***
*   *
*****
