*************
*         * *
***  ****   *
*           *
* *** *******
*   *     * *
* * *** * * *
* * *   * * *
* * * *   * *
* * * *     *
*   * ***** *
* *         *
*************
