***********
*         *
****  *****
*   *     *
* * *** * *
* *   * * *
* **  *** *
*   * *   *
**   ** * *
*         *
***********
