***********
*   *   * *
* *   * * *
*   * *   *
*  ** *** *
*     *   *
*** * * ***
*         *
* * ***** *
*         *
***********
