*************
*     *     *
* *** *  *  *
*   *   *   *
*** ***     *
*   *   * * *
*  ** *    **
* *   * *   *
* * *** **  *
* * *   * * *
* * *  **  **
*   *       *
*************
