*******
* *   *
* * ***
* *   *
* * * *
*     *
*******
