*********
* *     *
*    ** *
* *   * *
* * *   *
* * * * *
* * *   *
*       *
*********
