*****
*   *
* * *
* * *
*****
