*************
*           *
* * * *   * *
* * * *   * *
* * * * *****
* *   *     *
* **** **** *
* *         *
*** * *** * *
*   * * * * *
* *** * *   *
*     *     *
*************
