***********
*         *
* ** ** * *
*         *
***** * * *
*     *   *
*** *** * *
* * *   * *
* *** *** *
*     *   *
***********
