*******
*     *
*** * *
*   * *
* **  *
*   * *
*******
