*******
*     *
* * ***
* *   *
* *** *
*   * *
*******
