***********
*         *
* ******* *
* *   *   *
* * ***  **
* *       *
* *** * * *
*   *   * *
*** * * ***
*     *   *
***********
