***********
*   *     *
* *** * * *
* *   * * *
* * *** ***
*   *     *
*  **** * *
*       * *
********* *
*         *
***********
