*******
*   * *
* *** *
*     *
** ** *
*     *
*******
