*********
* *     *
* * * ***
*       *
* ***** *
*   * * *
*** * ***
*       *
*********
