*******
* *   *
* * * *
* * * *
*   * *
*     *
*******
