*******
*     *
* *****
* *   *
*  ** *
*     *
*******
