***********
*     * * *
* *** * * *
*   *     *
***    ** *
* * *   * *
* * * * * *
* * * *   *
* * * * * *
*   *     *
***********
