*********
* *   * *
* * * * *
*   * * *
* **  * *
*     * *
**  *** *
*       *
*********
