*********
* *     *
* * * * *
*   *   *
*** *** *
* * *   *
* **  * *
*     * *
*********
