*************
* *         *
* * ******* *
*   *   *   *
* * * *   * *
*   * * *   *
* *****  ** *
*     *   * *
***** * * ***
* *   * *   *
* * ***** * *
*         * *
*************
