*************
* *     *   *
* * * *   ***
* * * * *   *
* * * * *** *
*   * *     *
* *** **    *
*   *     * *
* * * *** * *
* * *   * * *
*         * *
* *   *   * *
*************
