*******
*     *
* * ***
* *   *
* *** *
*     *
*******
