*********
* *     *
* * *** *
*     * *
* ***** *
* *     *
* ** ****
*       *
*********
