*******
*     *
* *** *
* *   *
* * ***
*     *
*******
