***********
* *   *   *
* * *** * *
* *       *
* ** ** * *
* *     * *
* * *** * *
*   *   * *
* *** *** *
*   *     *
***********
