***********
*     *   *
* ***  ** *
* * * *   *
* * * * ***
* * * *   *
*   *  ** *
*   *   * *
***  ** * *
*         *
***********
