*********
* *     *
* * *** *
*     * *
* **  ***
* *     *
* ***** *
*       *
*********
