***********
*   *     *
* *** *** *
* *       *
* * *** * *
*     * * *
******* * *
*       * *
***** *   *
*       * *
***********
