*******
*     *
* * * *
* *   *
* * * *
* * * *
*******
