***********
*   *     *
*** *   * *
*     * * *
* * * *  **
*   *     *
*** *   * *
*     * * *
* **  * ***
*         *
***********
