*************
*       *   *
*    ** * * *
* *   * *   *
* *** * *** *
* * * *   * *
* *   ***** *
* *       * *
* * ** ** * *
* *     * * *
* * *** *   *
*   *   *   *
*************
