*********
*   *   *
* * * * *
* *   * *
******* *
*     * *
***** * *
*       *
*********
