*********
*       *
* ***** *
* *   * *
* * *** *
* * *   *
*** *  **
*       *
*********
