*******
*     *
* *** *
* *   *
* * ***
* *   *
*******
