***********
*         *
* *** *****
*   *     *
*** ***** *
* *     * *
* * * * * *
* *       *
* * ** ****
*         *
***********
